5 20
|------------------|
|.#................|
|..................|
|...............@..|
|------------------|